1 3 178 2865 107 
1 8 794 7168 305 3887 5162 1029 2603 600 
1 3 794 7168 305 
1 3 600 3788 4820 
1 5 305 4017 5923 6574 629 
1 5 794 5039 2517 3115 275 
1 3 4820 5426 557 
1 5 1252 7114 2416 1618 77 
1 6 292 5069 6201 6341 4217 321 
1 3 321 4130 27 
1 2 275 2739 
1 5 321 2233 5171 5727 3009 
1 33 27 6534 4898 1498 27 1789 6766 1489 5639 633 4217 4130 6506 3496 2990 5264 301 321 1003 6682 6341 7181 1840 4780 6157 2739 3474 6338 4558 3054 6275 275 13423 
1 3 36 7005 2512 
1 4 3009 5386 4359 129 
1 4 77 6181 4272 2940 
1 5 1820 2476 502 1056 127 
1 5 2940 3633 4685 272 871 
1 6 3009 1207 3134 3476 3017 1535 
1 7 2940 2489 5489 5330 6385 648 194 
1 4 2739 3474 6338 3358 
1 5 2512 2929 1604 42 503 
1 5 810 3618 5066 1042 310 
1 5 1820 248 5126 1650 414 
1 5 129 3015 4018 4677 208 
1 5 127 4240 2232 2385 177 
1 9 503 1317 503 42 6938 5674 5909 1604 13425 
1 7 1535 2347 5521 1826 5784 5251 6524 
1 3 503 4571 2037 
1 4 3358 6746 6776 6177 
1 32 208 5595 4805 380 7324 7075 5925 208 4115 4677 5673 4370 5003 4827 1810 6081 4018 1913 4382 3315 3015 382 1433 2242 6949 1132 129 4359 5752 5784 5251 6524 
1 4 68 3124 6576 4304 
1 2 4304 1099 
1 6 310 7180 6418 5343 6653 1078 
1 5 310 6603 3992 3616 1434 
1 5 68 7211 1142 7359 1050 
1 2 1906 383 
1 4 177 7128 4223 2458 
1 9 6177 3110 6877 3427 3173 5095 5151 2222 5192 
1 4 920 4743 4888 128 
1 10 414 2071 6256 7216 5804 6532 6922 7135 4286 4001 
1 7 4001 4286 7135 1460 2022 7243 28 
1 5 5192 5346 1641 5505 776 
1 6 68 950 5607 5848 2891 5113 
1 3 1585 5363 828 
1 5 383 6977 3473 1660 1025 
1 4 5113 5680 2719 756 
1 6 828 4068 5266 2181 2049 928 
1 4 776 5505 4201 286 
1 5 1985 2819 4632 2258 501 
1 5 28 6705 3229 2329 921 
1 5 2458 3682 711 3585 635 
1 3 4001 6672 391 
1 2 921 985 
1 3 5713 6178 5170 
1 6 756 7224 756 5182 5897 1176 
1 8 1025 4678 7010 1136 2769 4458 3211 7233 
1 5 1985 2413 3295 4228 848 
1 10 7233 6363 2753 5374 2985 1466 1974 5079 78 1931 
1 5 501 2643 5193 71 7085 
1 3 3357 5493 2588 
1 5 7233 3725 1865 2578 1016 
1 7 286 4201 2488 1770 2402 6070 2344 
1 2 848 929 
1 6 391 7241 4707 3503 7198 596 
1 3 830 4089 234 
1 3 7085 4882 4592 
1 3 4592 5888 2602 
1 3 7233 3868 5461 
1 4 830 4520 478 7389 
1 4 5461 4488 6419 4190 
1 4 596 1745 6102 367 
1 3 4592 3222 411 
1 2 411 3001 
1 3 1931 159 4059 
1 4 4190 6935 6538 2961 
1 5 2344 3293 4269 6330 3758 
1 3 7389 4344 6712 
1 5 2588 4952 460 1969 6568 
1 6 234 7370 139 3091 510 6901 
1 4 2602 3532 7358 4427 
1 2 579 1069 
1 4 6901 1155 3807 1284 
1 4 5461 952 6098 2947 
1 3 2961 2395 1084 
1 4 3001 4466 5604 1213 
1 3 1284 4750 5905 
1 3 6901 3340 431 
1 6 6 4613 1041 781 3825 4710 
1 5 3758 421 611 4753 5009 
1 4 6712 131 6135 3642 
1 2 1213 4192 
1 2 6568 12566 
1 5 3758 7301 1181 1808 66 
1 4 3642 95 6437 7121 
1 4 1084 3183 5404 1313 
1 2 6568 12566 
1 5 1313 1954 4892 1652 2014 
1 4 66 6278 4281 524 
1 4 6826 733 2873 5577 
1 2 450 259 
1 6 4710 1442 807 2019 4939 357 
1 6 4427 5265 4368 5257 400 3880 
1 2 3880 7472 
1 4 7121 3518 2679 13439 
1 3 259 3805 2103 
1 5 4192 7040 5953 4121 1830 
1 7 6826 1723 5621 2171 6089 6375 368 
1 3 1830 3915 2234 
1 4 1085 5406 2686 1144 
1 5 3880 704 2220 4262 2203 
1 4 1830 3305 7061 2995 
1 6 524 6867 7213 965 5411 549 
1 6 368 6375 1673 7384 4426 2945 
1 4 357 6304 5864 768 
1 5 2995 1504 3069 3368 2788 
1 3 2788 6824 1936 
1 5 768 1402 4263 1613 1526 
1 5 549 2434 3654 5237 4479 
1 4 349 1915 710 12943 
1 5 2103 2380 6595 4327 7 
1 4 6388 5441 1272 7131 
1 8 368 2708 2398 1960 5846 1875 6711 2290 
1 3 2945 3256 7199 
1 4 4294 5731 1240 784 
1 3 7 3373 376 
1 4 7 6384 2924 4383 
1 7 89 1224 3998 5014 1626 4621 444 
1 5 4294 7175 1713 5664 3089 
1 4 3089 6997 4353 666 
1 3 444 6809 870 
1 7 549 1701 1201 2800 2852 1589 213 
1 6 7131 4453 5943 7362 6207 1273 
1 26 89 1224 5401 7306 1951 3281 1319 3998 5014 98 4509 2164 6133 1259 58 3607 3290 6693 512 6227 3752 1393 1467 3956 5354 1167 
1 4 1273 6207 3083 627 
1 3 237 6860 404 
1 3 627 6458 4078 
1 4 870 764 23 2227 
1 4 213 805 5136 749 
1 4 1273 4994 3676 836 
1 2 749 1644 
1 4 237 4829 4102 3670 
1 4 1477 2287 3244 307 
1 5 951 4928 615 5869 5930 
1 6 376 419 6258 7386 3854 5408 
1 14 1167 5542 1167 5354 3956 1467 1393 3752 6227 512 6693 3290 3607 58 
1 2 836 10865 
1 5 58 3607 3290 6693 512 
1 3 512 6693 3290 
1 6 307 3495 2322 4903 7046 3139 
1 10 2788 6084 4210 981 5320 4531 602 3227 5368 2948 
1 3 3139 6602 4157 
1 4 512 5820 814 454 
1 14 454 5834 7219 5880 7406 7104 4696 224 603 2541 3314 5289 2386 243 
1 9 5930 6779 5805 533 491 1195 6536 5181 5110 
1 2 5110 4073 
1 4 4157 6277 5442 987 
1 5 4157 6602 2151 3236 7352 
1 4 2948 5574 7017 422 
1 2 5110 12767 
1 10 666 4660 5149 3754 601 2387 2771 4863 671 1740 
1 2 1740 4096 
1 7 3290 2091 7051 5056 1270 1792 2144 
1 2 4096 6002 
1 6 6002 3789 408 4337 3796 2113 
1 3 2113 1246 1035 
1 4 454 1297 224 603 
1 7 2495 2732 5640 183 5190 6184 2773 
1 2 2773 110 
1 3 110 5462 215 
1 2 4073 13462 
1 5 1672 3462 3396 4654 3426 
1 4 422 3247 2085 2217 
1 2 3426 2250 
1 4 987 2510 529 4981 
1 3 2495 6921 2792 
1 4 243 6462 1371 1080 
1 4 2144 7126 9 2236 
1 7 2217 6631 4338 2217 6726 1168 99 
1 4 664 6714 2593 1490 
1 10 422 7017 422 3247 2085 4933 6811 1994 4122 453 
1 3 1490 5487 4891 
1 20 2792 4931 2792 6921 2495 4158 5585 6302 6572 2893 4106 5160 5129 5190 5564 5640 2732 2209 4454 13465 
1 4 603 2541 6030 61 
1 5 1080 1842 5135 1743 1389 
1 3 61 1482 1177 
1 3 188 7298 3511 
1 3 99 5053 403 
1 5 4891 2841 4697 72 184 
1 2 184 72 
1 2 72 708 
1 6 403 3098 2521 2419 3321 2835 
1 4 3511 7043 7311 1553 
1 4 664 6246 2943 879 
1 4 879 5566 6042 1410 
1 4 1264 6937 1414 766 
1 3 766 824 760 
1 4 1895 4137 3687 2912 
1 6 766 775 217 6889 1822 189 
1 12 2835 4742 2887 2715 5403 4828 774 97 4135 1365 6778 753 
1 2 189 1822 
1 3 2912 6709 1855 
1 2 879 4767 
1 4 753 6778 2138 456 
1 6 1410 3144 1190 2184 6387 2606 
1 12 753 6209 7044 5130 5202 6339 7188 6020 753 1718 5064 6390 
1 3 1868 3665 2579 
1 5 2606 3759 1479 4257 881 
1 5 2579 7107 3962 4320 1912 
1 6 1855 6351 5913 1546 933 859 
1 3 881 4184 304 
1 3 2956 5785 1286 
1 6 2956 5269 6849 1636 5267 6662 
1 6 859 933 7149 3259 967 5981 
1 6 6662 4602 672 4799 3414 3680 
1 5 859 4625 511 4044 83 
1 4 5981 4048 849 2389 
1 2 83 1455 
1 3 2020 5376 2061 
1 4 1286 1339 5104 229 
1 5 6662 4279 325 5177 112 
1 9 718 4569 7156 5986 833 7333 6179 3894 2754 
1 4 2061 4921 7222 3081 
1 5 1455 2768 2223 6713 4661 
1 6 3081 7279 847 2988 6760 1226 
1 6 4661 1569 5486 377 1174 589 
1 4 229 4030 4594 526 
1 2 589 655 
1 2 526 76 
1 9 2754 2974 3652 5637 3677 1527 6005 1623 2043 
1 4 2043 1623 6005 1527 
1 3 76 4701 439 
1 3 362 5628 1516 
1 2 263 295 
1 6 2043 3100 3516 195 3271 1279 
1 3 1516 5248 4349 
1 5 1516 954 5504 7071 6443 
1 4 1279 4083 4204 2601 
1 2 59 1771 
1 5 210 3875 1104 6242 192 
1 4 2192 6647 6285 386 
1 5 6443 6213 5496 5661 1173 
1 7 2601 7067 2601 7317 6232 6683 850 
1 5 4349 5071 1889 6948 1436 
1 3 1341 5458 1341 
1 3 192 4874 1845 
1 2 1436 3669 
1 7 386 5236 5055 378 4522 5415 3116 
1 3 3669 3206 3153 
1 6 1771 6374 4573 4028 6986 141 
1 3 141 1189 21 
1 3 21 1189 614 
1 5 1845 2539 3709 1295 546 
1 4 3116 3212 4936 3824 
1 5 546 1858 5935 309 173 
1 10 1173 6145 5661 2630 3317 3443 283 2400 4196 111 
1 4 3824 4695 5576 595 
1 5 541 839 1006 3220 654 
1 5 2378 2411 1492 2440 508 
1 3 532 7116 51 
1 5 595 7255 1258 2053 2691 
1 6 508 1431 3522 4071 1337 904 
1 8 904 6543 1554 6082 280 4540 7257 2180 
1 2 2691 1746 
1 7 173 5983 4476 4690 3491 4200 3341 
1 3 654 3191 1508 
1 3 2691 3718 4783 
1 3 3341 5397 4202 
1 5 904 6543 1554 6082 280 
1 4 2180 6587 6271 297 
1 5 280 7148 6768 962 1753 
1 3 4202 5793 4452 
1 2 1753 2569 
1 6 51 2984 5416 5409 6175 714 
1 2 340 264 
1 7 2569 6398 5477 2441 792 2486 438 
1 5 2569 1458 2172 739 2001 
1 6 4783 757 4332 7248 3225 563 
1 5 4452 6998 6383 2574 157 
1 3 2001 5654 2172 
1 6 4503 220 3283 4199 6300 738 
1 7 297 5306 2810 4231 5958 5228 835 
1 3 157 6091 2585 
1 5 264 619 2744 5965 831 
1 3 835 5993 815 
1 6 4503 4693 5068 5543 7407 388 
1 4 815 896 5608 5540 
1 7 714 3242 5316 1232 7398 2177 863 
1 6 815 4331 3433 2210 6378 347 
1 3 2265 4024 5941 
1 5 563 7303 5960 5741 1007 
1 3 347 3684 242 
1 4 5941 2503 3425 13117 
1 3 4836 547 5161 
1 6 831 3811 1294 1625 6800 1367 
1 4 242 6515 5184 1163 
1 2 5161 211 
1 4 242 5353 32 7247 
1 5 4836 6231 1950 1502 3239 
1 2 1163 6866 
1 3 1367 6674 1707 
1 3 1597 7160 60 
1 6 211 4045 5334 5145 2254 754 
1 3 754 1137 1192 
1 5 3239 4739 6677 202 3714 
1 2 1192 2041 
1 6 60 2375 1619 3653 2552 878 
1 5 6866 2558 3430 6700 223 
1 3 2041 4407 3662 
1 4 223 399 4108 3877 
1 4 4807 140 2281 2243 
1 5 3662 6592 1255 4816 930 
1 6 3877 2418 87 4092 4099 1940 
1 2 930 255 
1 3 2243 5708 809 
1 4 373 2577 3428 910 
1 5 809 2283 4399 3967 266 
1 5 255 1298 3545 2808 3118 
1 5 910 5990 5077 1955 617 
1 4 3118 6123 2473 4019 
1 3 617 642 851 
1 4 4019 1305 1578 4554 
1 5 266 3881 2467 4732 73 
1 3 851 5038 281 
1 5 326 1717 1186 6158 265 
1 2 73 4181 
1 5 4554 2031 6064 4871 3781 
1 3 265 3074 812 
1 2 3781 174 
1 5 174 269 3872 1404 3035 
1 5 1451 3764 2224 1183 2179 
1 4 2179 6940 4266 1145 
1 3 4745 1605 1000 
1 6 4229 6868 4139 2608 2186 887 
1 4 4229 5761 5400 2481 
1 3 887 2629 818 
1 4 2481 2494 1495 20 
1 3 20 6659 1728 
1 5 432 4986 6104 1767 2584 
1 3 2584 620 3277 
1 3 2584 2699 1113 
